1111111111111
1P0CCC0000CC1
1010101010101
100000CCCC001
1010101010101
1C0000000CC01
1C10101010101
1000CCCCC00E1
1111111111111