11111111111111111
1C010000010C001P1
11000000010100101
1100CCC000011C101
1000000E000010001
11111111111111111