11111111111111111111111
1111100CC01111111111111
11111010101111111111111
111P0000001110011100111
11101010101110011100111
11100CCCC011100000CC111
11101010101110101010111
111CC000000000000000111
11101010101010101010111
11100000000CCCC00000111
11111010101011101010111
11111CC000001110CC0E111
11111111111111111111111